UDF	undefined nucleus
UDFn	undefined nerve
BC	Brachium Conjunctivum
EmGr	Eminentia Granularis
VMu	nucleus trigeminalis descendens, pars Muralis
VIp	nucleus trigeminalis descendens, pars Interpolaris
PrVd	nucleus trigeminalis principalis, pars dorsalis
VIpp	nucleus trigeminalis descendens interpolaris, pars posterior
VOrp	nucleus trigeminalis descendens Oralis, pars posterior
PrVv	nucleus trigeminalis principalis, pars ventralis
VOra	nucleus trigeminalis descendens Oralis pars anterior
preV	nucleus pretrigeminalis??
TrVdes	Tractus trigemini descendens
UDFtr	Undefined Tract
VOri	nucleus trigeminalis descendens Oralis, pars intermedius
Vcd	nucleus trigemini descendens, pars caudalis/spinialis
CereNuc	Deep cerebellar nuclei
9N	glossopharyngeal nucleus
RtTgD	reticulotegmental nucleus of the pons, dorsal part
Nuc1	undefined nucleus 1
Nuc2	undefined nucleus 2
LM1	moderate sized dense area, at 4th ventricle floor and frontal to sp5
LM1C	LM1, caudal part
LM1R	LM1, rostral part
7N2	facial nucleus, anterior subpart
bv1	Blood Vessel 1
bv2	Blood Vessel 2
bv3	Blood Vessel 3
bv4	Blood Vessel 4
bv5	Blood Vessel 5
bv6	Blood Vessel 6
bv7	Blood Vessel 7
bv8	Blood Vessel 8
bv9	Blood Vessel 9
bv10	Blood Vessel 10
bv11	Blood Vessel 11
bv12	Blood Vessel 12
LC2	Locus Coeruleus, long cell part
Pn2	Pontine nuclei, sparse part
7n1	facial nerve, small 1
7n2	facial nerve, small 2
7n3	facial nerve, small 3
DDGC	Dorsal Deiters Gigantocellular Nucleus
IC	inferior colliculus
SOC	Superior Olivary Complex
Cb	Cerebellum
