1/2Cb	lobules 1 and 2 of the cerebellar vermis
10Cb	lobule 10 of the cerebellar vermis
10N	dorsal motor nucleus of vagus
10n	vagus nerve
11n	accessory nerve
11N	accessory nerve nucleus
12GH	hypoglossal nucleus, geniohyoid part
12n	hypoglossal nerve
12N	hypoglossal nucleus
1Cb	lobule 1 of the cerebellar vermis
2/3Cb	lobules 2 and 3 of the cerebellar vermis
2Cb	lobule 2 of the cerebellar vermis
2n	optic nerve
3Cb	lobule 3 of the cerebellar vermis
3n	oculomotor nerve
3N	oculomotor nucleus
3PC	oculomotor nucleus, parvicellular part
3V	3rd ventricle
4/5Cb	lobules 4 and 5 of the cerebellar vermis
4Cb	lobule 4 of the cerebellar vermis
4n	trochlear nerve
4N	trochlear nucleus
4Sh	trochlear nucleus shell region
4V	4th ventricle
5ADi	motor trigeminal nucleus, anterior digastric part
5Ma	motor trigeminal nucleus, masseter part
5N	motor trigeminal nucleus
5n	trigeminal nerve
5Sol	trigeminal-solitary transition zone
5Te	motor trigeminal nucleus, temporalis part
5Tr	trigeminal transition zone
5TT	motor trigeminal nucleus, tensor tympani part
6Cb	lobule 6 of the cerebellar vermis
6N	abducens nucleus
6RB	abducens nucleus, retractor bulbi part
7Cb	lobule 7 of the cerebellar vermis
7DI	facial nucleus, dorsal intermediate subnucleus
7DL	facial nucleus, dorsolateral subnucleus
7DM	facial nucleus, dorsomedial subnucleus
7L	facial nucleus, lateral subnucleus
7n	facial nerve
7N	facial nucleus
7SH	facial motor nucleus, stylohyoid part
7VI	facial nucleus, ventral intermediate subnucleus
7VM	facial nucleus, ventromedial subnucleus
8Cb	lobule 8 of the cerebellar vermis
8cn	cochlear root of the vestibulocochlear nerve
8n	vestibulocochlear nerve
8vn	vestibular nerve
9Cb	glossopharyngeal and vagus nerves
9n	glossopharyngeal nerve
a	artery
A1	A1 noradrenaline cells
A11	A11 dopamine cells
A12	A12 dopamine cells
A13	A13 dopamine cells
A14	A14 dopamine cells
A2	A2 noradrenaline cells
A5	A5 noradrenaline cells
A7	A7 noradrenaline cells
A8	A8 dopamine cells
AA	anterior amygdaloid area
ac	anterior commissure
AC	nucleus of the anterior commissure
aca	anterior commissure, anterior part
Acb	accumbens nucleus
AcbC	accumbens nucleus, core
AcbSh	accumbens nucleus, shell
aci	anterior commissure, intrabulbar part
ACo	anterior cortical amygdaloid area
acp	anterior commissure, posterior nerve
acs7	accessory facial nerve
AD	anterodorsal thalamic nucleus
AHA	anterior hypothalamic area, anterior part
AHC	anterior hypothalamic area, central part
AHi	amygdalohippocampal area
AHiAL	amygdalohippocampal area, anterolateral part
AHiPL	amygdalohippocampal area, posterolateral
AHiPM	amygdalohippocampal area, posteromedial part
AHP	anterior hypothalamic area, posterior part
AI	agranular insular cortex
AID	agranular insular cortex, dorsal part
AIP	agranular insular cortex, posterior part
AIV	agranular insular cortex, ventral part
alv	alveus of the hippocampus
AM	anteromedial thalamic nucleus
Amb	ambiguus nucleus
AmbC	ambiguus nucleus, compact part
AmbL	ambiguus nucleus, loose part
AMV	anteromedial thalamic nucleus, ventral part
AngT	angular thalamic nucleus
ANS	accessory neurosecretory nuclei
AOB	accessory olfactory bulb
AOD	anterior olfactory area, dorsal part
AOE	anterior olfactory area external part
AOL	anterior olfactory area lateral part
AOM	anterior olfactory area medial part
AOP	anterior olfactory area posterior part
aot	accessory olfactory tract
AOV	anterior olfactory area ventral part
AP	area postrema
APF	anterior perifornical nucleus
APir	amygdalopiriform transition area
APit	anterior lobe of the pituitary
apmf	ansoparamedian fissure
APT	anterior pretectal nucleus
APTD	anterior pretectal nucleus, dorsal part
APTV	anterior pretectal nucleus, ventral part
Aq	aqueduct
Arc	arcuate hypothalamic nucleus
ArcD	arcuate hypothalamic nucleus, dorsal part
ArcL	arcuate hypothalamic nucleus, lateral part
ArcLP	arcuate hypothalamic nucleus, lateroposterior part
ArcM	arcuate hypothalamic nucleus, medial part
ArcMP	arcuate hypothalamic nucleus, medial posterior part
asc7	ascending fibers of the facial nerve
ASt	amygdalostriatal transition area
ATg	anterior tegmental nucleus
Au1	primary auditory cortex
AuD	secondary auditory cortex, dorsal area
AuV	secondary auditory cortex, ventral area
AV	anteroventral thalamic nucleus
AVDM	anterovent thalamic nucleus, dorsomedial part
AVPe	anteroventral periventricular nucleus
AVVL	anteroventral thalamic nucleus, ventrolateral part
azac	azygous anterior cerebral artery
B	basal nucleus (Meynert)
B4	B4 serotonin cells
B9	B9 serotonin cells
BAC	bed nucleus of the anterior commissure
BAOT	bed nucleus of the accessory olfactory tract
Bar	Barrington's nucleus
bas	basilar artery
bic	brachium of the inferior colliculus
BIC	nucleus of the brachium of the inferior colliculus
BL	basolateral amygdaloid nucleus
BLA	basolateral amygdaloid nucleus, anterior part
BLP	basolateral amygdaloid nucleus, posterior part
BLV	basolateral amygdaloid nucleus, ventral part
BMA	basomedial amygdaloid nucleus, anterior part
BMP	basomedial amygdaloid nucleus, posterior part
Bo	Botzinger complex
bsc	brachium of the superior colliculus
C1	C1 adrenaline cells
C1/A1	C1 adrenaline cells and A1 noradrenaline cells
C2	C2 adrenaline cells
C3	C3 adrenaline cells
CA1	field CA1 of the hippocampus
CA2	field CA2 of the hippocampus
CA3	field CA3 of the hippocampus
CAT	nucleus of the central acoustic tract
CB	cell bridges of the ventral striatum
cbc	cerebellar commissure
cbw	cerebellar white matter
CC	central canal
cc	corpus callosum
CeC	central amygdaloid nucleus, capsular part
CeCv	central cervical nucleus of the spinal cord
CeL	central amygdaloid nucleus, lateral division
CeM	central amygdaloid nucleus, medial division
CEnt	caudomedial entothinal cortex
CG	central gray
cg	cingulum
Cg1	cingulate cortex, area 1
Cg2	cingulate cortex, area 2
CGA	central gray, alpha part
CGB	central gray, beta part
CGG	central gray, gamma part
CGO	central gray, nucleus O
CGPn	central gray of the pons
chp	choroid plexus
CI	caudal interstitial nucleus of the medial longitudina
CIC	central nucleus of the inferior colliculus
cic	commissure of the inferior colliculus
Cir	circular nucleus
CL	centrolateral thalamic nucleus
Cl	claustrum
CLi	caudal linear nucleus of the raphe
cll	commissure of the lateral lemniscus
CM	central medial thalamic nucleus
CnF	cuneiform nucleus
CnFV	cuneiform nucleus, ventral part
Com	commissural nucleus of the inferior colliculus
Cop	copula of the pyramis
cp	cerebral peduncle
CPO	caudal periolivary nucleus
CPu	caudate putamen (striatum)
Crus1	crus 1 of the ansiform lobule
Crus2	crus 2 of the ansiform lobule
csc	commissure of the superior colliculus
cst	commissural stria terminalis
cu	cuneate fasciculus
Cu	cuneate nucleus
CuR	cuneate nucleus, rotundus part
CVL	caudoventrolateral reticular nucleus
CxA	cortex-amygdala transition zone
D3V	dorsal 3rd ventricle
DA	dorsal hypothalamic area
das	dorsal acoustic stria
DC	dorsal cochlear nucleus
DCDp	dorsal cochlear nucleus, deep layer
DCFu	dorsal cochlear nucleus, fusiform layer
DCGr	dorsal cochlear nucleus, granular layer
DCIC	dorsal cortex of the inferior colliculus
DCl	dorsal part of claustrum
DCMo	dorsal cochlear nucleus, molecular layer
DEn	dorsal endopiriform claustrum
df	dorsal fornix
DG	dentate gyrus
dhc	dorsal hippocampal commissure
DI	dysgranular insular cortex
DIEnt	dorsal intermediate entorhinal cortex
Dk	nucleus of Darkschewitsch
DLEnt	dorsolateral entorhinal cortex
DLG	dorsal lateral geniculate nucleus
DLL	dorsal nucleus of the lateral lemniscus
dlo	dorsal lateral olfactory tract
DLO	dorsolateral orbital cortex
DLPAG	dorsolateral periaqueductal gray
DM	dorsomedial hypothalamic nucleus
DMC	dorsomedial hypothalamic nucleus, compact part
DMD	dorsomedial hypothalamic nucleus, dorsal part
DMPAG	dorsomedial periaqueductal gray
DMSp5	dorsomedial spinal trigeminal nucleus
DMTg	dorsomedial tegmental area
DMV	dorsomedial hypothalamic nucleus, ventral part
DP	dorsal peduncular cortex
DpG	deep gray layer of the superior colliculus
DPGi	dorsal paragigantocellular nucleus
DPO	dorsal periolivary region
DpWh	deep white layer of the superior colliculus
DR	dorsal raphe nucleus
DRC	dorsal raphe nucleus, caudal part
DRD	dorsal raphe nucleus, dorsal part
DRI	dorsal raphe, interfascicular part
DRL	dorsal raphe nucleus, lateral part
DRV	dorsal raphe nucleus, ventral part
DS	dorsal subiculum
dsc	dorsal spinocerebellar tract
dsc/oc	dorsal spinocerebellar tract and olivocerebellar trac
DT	dorsal terminal nucleus
DTg	dorsal tegmental nucleus
DTgC	dorsal tegmental nucleus, central part
DTgP	dorsal tegmental nucleus, pericentral part
dtgx	dorsal tegmental decussation
DTM	dorsal tuberomammillary nucleus
DTr	dorsal transition zone
DTT	dorsal tenia tecta
E/OV	ependymal and subendymal layer/olfactory ventricle
EA	extended amygdala
EAC	extended amygdala, central part
EAM	extended amygdala, medial part
ec	external capsule
ECIC	external cortex of the inferior colliculus
Ect	ectorhinal cortex
ECu	external cuneate nucleus
EF	epifascicular nucleus
eml	external medullary lamina
EP	entopeduncular nucleus
Epl	external plexiform layer of the olfactory bulb
EPlA	external plexiform layer of the accessory olfactory b
ERS	epirubrospinal nucleus
ESO	episupraoptic nucleus
Eth	ethmoid thalamic nucleus
EVe	nucleus of origin of the efferent fibers of the vesti
EW	Edinger-Westphal nucleus
f	fornix
F	nucleus of the fields of Forel
FC	fasciola cinereum
FF	fields of Forel
fi	fimbria of the hippocampus
Fl	flocculus
fmi	forceps minor of the corpus callosum
fmj	forceps major of the corpus callosum
fr	fasciculus retroflexus
Fr3	frontal cortex, area 3
FrA	frontal association cortex
Fu	bed nucleus of the stria terminalis, fusiform part
FVe	F cell group of the vestibular complex
g7	genu of the facial nerve
gcc	genu of the corpus callosum
Ge5	gelatinous layer of the caudal spinal trigeminal nucl
Gem	gemini hypothalamic nucleus
Gi	gigantocellular reticular nucleus
GI	granular insular cortex
GiA	gigantocellular reticular nucleus, alpha part
GiV	gigantocellular reticular nucleus, ventral part
Gl	glomerular layer of the olfactory bulb
GlA	glomerular layer of the accessory olfactory bulb
GP	globus pallidus
gr	gracile fasciculus
Gr	gracile nucleus
GrA	granule cell layer of the accessory olfactory bulb
GrC	granule cell layer of cochlear nuclei
GrDG	granule cell layer of the dentate gyrus
GrO	granule cell layer of the olfactory bulb
hbc	habenular commissure
HDB	nucleus of the horizontal limb of the diagonal band
hif	hippocampal fissure
I	intercalated nuclei of the amygdala
I8	interstitial nucleus of the vestibulocochlear nerve
IAD	interanterodorsal thalamic nucleus
IAM	interanteromedial thalamic nucleus
ic	internal capsule
icf	intercrural fissure
ICj	island of Calleja
ICjM	island of Calleja, major island
icp	inferior cerebellar peduncle
ictd	internal carotid artery
IEn	intermediate endopiriform claustrum
IF	interfascicular nucleus
IG	indusium griseum
IGL	intergeniculate leaflet
IL	infralimbic cortex
ILL	intermediate nucleus of the lateral lemniscus
IM	intercalated amygdaloid nucleus, main part
IMA	intramedullary thalamic area
IMD	intermediodorsal thalamic nucleus
IMG	amygdaloid intramedullary gray
iml	internal medullary lamina
In	intercalated nucleus
InC	interstitial nucleus of Cajal
InCSh	interstitial nucleus of Cajal, shell region
Inf	infundibulum
InG	intermediate gray layer of the superior colliculus
InM	intermedius nucleus of the medulla
IntA	interposed cerebellar nucleus, anterior part
IntDL	interposed cerebellar nucleus, dorsolateral hump
IntP	interposed cerebellar nucleus, posterior part
IntPPC	interposed cerebellar nucleus, posterior parvicellula
InWh	intermediate white layer of the superior colliculus
IO	inferior olivary nucleus
IOA	inferior olive, subnucleus A of medial nucleus
IOB	inferior olive, subnucleus B of medial nucleus
IOBe	inferior olive, beta subnucleus
IOC	inferior olive, subnucleus C of medial nucleus
IOD	inferior olive, dorsal nucleus
IODM	inferior olive, dorsomedial cell group
IOK	inferior olive, cap of Kooy of the medial nucleus
IOM	inferior olive, medial nucleus
IOPr	inferior olive, principal nucleus
IOVL	inferior olive, ventrolateral protrusion
IP	interpeduncular nucleus
IPA	interpeduncular nucleus, apical subnucleus
IPAC	interstitial nucleus of the posterior limb of the ant
IPACL	interstitial nucleus of the posterior limb of the ant
IPACM	interstitial nucleus of the posterior limb of the ant
IPC	interpeduncular nucleus, caudal subnucleus
IPDL	interpeduncular nucleus, dorsolateral subnucleus
IPDM	interpeduncular nucleus, dorsomedial subnucleus
IPF	interpeduncular fossa
IPI	interpeduncular nucleus, intermediate subnucleus
IPl	internal plexiform layer of the olfactory bulb
IPL	interpeduncular nucleus, lateral subnucleus
IPR	interpeduncular nucleus, rostral subnucleus
IRt	intermediate reticular nucleus
IRtA	intermediate reticular nucleus, alpha part
IS	inferior salivatory nucleus
isRt	isthmic reticular formation
IVF	interventricular foramen
JPLH	juxtaparaventricular part of lateral hypothalamus
KF	Klliker-Fuse nucleus
La	lateral amygdaloid nucleus
LA	lateroanterior hypothalamic nucleus
lab	longitidinal association bundle
LAcbSh	lateral accumbens shell
LaDL	lateral amygdaloid nucleus, dorsolateral part
Lat	lateral cerebellar nucleus
LatPC	lateral cerebellar nucleus, parvicellular part
LaVL	lateral amygdaloid nucleus, ventrolateral part
LaVM	lateral amygdaloid nucleus, ventromedial part
LC	locus coeruleus
Ld	lambdoid septal zone
LD	laterodorsal thalamic nucleus
LDDM	laterodorsal thalamic nucleus, dorsomedial part
LDTg	laterodorsal tegmental nucleus
LDTgV	laterodorsal tegmental nucleus, ventral part
LDVL	laterodorsal thalamic nucleus, ventrolateral part
lfp	longitudinal fasciculus of the pons
LH	lateral hypothalamic area
LHb	lateral habenular nucleus
LHbL	lateral habenular nucleus, lateral part
LHbM	lateral habenular nucleus, medial part
Li	linear nucleus of the medulla
ll	lateral lemniscus
LM	lateral mammillary nucleus
LMol	lacunosum moleculare layer of the hippocampus
lo	lateral olfactory tract
LO	lateral orbital cortex
LOT	nucleus of the lateral olfactory tract
LP	lateral posterior thalamic nucleus
LPAG	lateral periaqueductal gray
LPB	lateral parabrachial nucleus
LPBC	lateral parabrachial nucleus, central part
LPBCr	lateral parabrachial nucleus, crescent part
LPBD	lateral parabrachial nucleus, dorsal part
LPBE	lateral parabrachial nucleus, external part
LPBI	lateral parabrachial nucleus, internal part
LPBS	lateral parabrachial nucleus, superior part
LPBV	lateral parabrachial nucleus, ventral part
LPGi	lateral paragigantocellular nucleus
LPGiA	lateral paragigantocellular nucleus, alpha part
LPGiE	lateral paragigantocellular nucleus, external part
LPLC	lateral posterior thalamic nucleus, laterocaudal part
LPLR	lateral posterior thalamic nucleus, laterorostral part
LPMC	lateral posterior thalamic nucleus, mediocaudal part
LPMR	lateral posterior thalamic nucleus, mediorostral part
LPO	lateral preoptic area
LPtA	lateral parietal association cortex
LR4V	lateral recess of the 4th ventricle
LRt	lateral reticular nucleus
LRtPC	lateral reticular nucleus, parvicellular part
LRtS5	lateral reticular nucleus, subtrigeminal part
LSD	lateral septal nucleus, dorsal part
LSI	lateral septal nucleus, intermediate part
LSO	lateral superior olive
LSS	lateral stripe of the striatum
LSV	lateral septal nucleus, ventral part
LT	lateral terminal nucleus (pretectum)
Lth	lithoid nucleus
LV	lateral ventricle
LVe	lateral vestibular nucleus
LVPO	lateroventral periolivary nucleus
M1	primary motor cortex
M2	secondary motor cortex
m5	motor root of the trigeminal nerve
MA3	medial accessory oculomotor nucleus
mcer	middle cerebral artery
MCLH	magnocellular nucleus of the lateral hypothalamus
mcp	middle cerebellar peduncle
MCPC	magnocellular nucleus of the posterior commissure
MCPO	magnocellular preoptic nucleus
MD	mediodorsal thalamic nucleus
MDC	mediodorsal thalamic nucleus, central part
MdD	medullary reticular nucleus, dorsal part
MDL	mediodorsal thalamic nucleus, lateral part
MDM	mediodorsal thalamic nucleus, medial part
MdV	medullary reticular nucleus, ventral part
Me	medial amygdaloid nucleus
ME	median eminence
Me5	mesencephalic trigeminal nucleus
me5	mesencephalic trigeminal tract
MeA	medial amygdaloid nucleus, anterior part
MeAD	medial amygdaloid nucleus, anterodorsal
MeAV	medial amygdaloid nucleus, anteroventral part
Med	medial cerebellar nucleus
MedDL	medial cerebellar nucleus, dorsolateral protuberance
MedL	medial cerebellar nucleus, lateral part
MEnt	medial entorhinal cortex
MePD	medial amygdaloid nucleus, posterodorsal part
MePV	medial amygdaloid nucleus, posteroventral part
mfb	medial forebrain bundle
mfba	medial forebrain bundle, 'a' component
MG	medial geniculate nucleus
MGD	medial geniculate nucleus, dorsal part
MGM	medial geniculate nucleus, medial part
MGV	medial geniculate nucleus, ventral part
MHb	medial habenular nucleus
Mi	mitral cell layer of the olfactory bulb
MiA	mitral cell layer of the accessory olfactory bulb
MiTg	microcellular tegmental nucleus
ml	medial lemniscus
ML	medial mammillary nucleus, lateral part
mlf	medial longitudinal fasciculus
MM	medial mammillary nucleus, medial part
MnA	median accessory nucleus of the medulla
MnM	medial mammillary nucleus, median part
MnPO	median preoptic nucleus
MnR	median raphe nucleus
MO	medial orbital cortex
MoDG	molecular layer of the dentate gyrus
mp	mammillary peduncle
MPA	medial preoptic area
mPAG	mesencephalic periaqueductal gray
MPB	medial parabrachial nucleus
MPBE	medial parabrachial nucleus external part
MPL	medial paralemniscial nucleus
MPO	medial preoptic nucleus
MPOL	medial preoptic nucleus, lateral part
MPOM	medial preoptic nucleus, medial part
MPT	medial pretectal nucleus
MPtA	medial parietal association cortex
MRe	mammillary recess of the 3rd ventricle
mRt	mesencephalic reticular formation
MS	medial septal nucleus
MSO	medial superior olive
mt	mammillothalamic tract
MT	medial terminal nucleus
mtg	mammillotegmental tract
MTu	medial tuberal nucleus
MVe	medial vestibular nucleus
MVeMC	medial vestibular nucleus, magnocellular part
MVePC	medial vestibular nucleus, parvicellular part
MVPO	medioventral periolivary nucleus
Mx	matrix region of the medulla
MZMG	marginal zone of the medial geniculate
ns	nigrostriatal tract
Nv	navicular postolfactory nucleus
oc	olivocerebellar tract
ocb	olivocochlear bundle
och	optic chiasm
ON	olfactory nerve layer
Op	optic nerve layer of the superior colliculus
OPC	oval paracentral thalamic nucleus
OPT	olivary pretectal nucleus
opt	optic tract
Or	oriens layer of the hippocampus
OT	nucleus of the optic tract
OV	olfactory ventricle (olfactory part of lateral ventri
p1PAG	p1 periaqueductal gray
p1Rt	p1 reticular formation
P5	peritrigeminal zone
P7	perifacial zone
Pa4	paratrochlear nucleus
Pa5	paratrigeminal nucleus
Pa6	paraabducens nucleus
PaAP	paraventricular hypothalamic nucleus, anterior parvic
PaDC	paraventricular hypothalamic nucleus, dorsal cap
PAG	periaqueductal gray
PaLM	paraventricular hypothalamic nucleus, lateral magnoce
PaMM	paraventricular hypothalamic nucleus, medial magnocel
PaMP	paraventricular hypothalamic nucleus, medial parvicel
PaPo	paraventricular hypothalamic nucleus, posterior part
PaR	pararubral nucleus
PaS	parasubiculum
PaV	paraventricular hypothalamic nucleus, ventral part
PaXi	paraxiphoid nucleus of thalamus
PBG	parabigeminal nucleus
PBP	parabrachial pigmented nucleus of the VTA
PC	paracentral thalamic nucleus
pc	posterior commissure
PCGS	paracochlear glial substance
pcn	precentral fissure
PCom	nucleus of the posterior commissure
PCRt	parvicellular reticular nucleus
PCRtA	parvicellular reticular nucleus, alpha part
pcuf	preculminate fissure
PDR	posterodorsal raphe nucleus
PDTg	posterodorsal tegmental nucleus
Pe	periventricular hypothalamic nucleus
PeF	perifornical nucleus
PeFLH	perifornical part of lateral hypothalamus
PF	parafascicular thalamic nucleus
PFl	paraflocculus
pfs	parafloccular sulcus
PG	pregeniculate nucleus
PGMC	pregeniculate nucleus, magnocellular part
PGPC	pregeniculate nucleus, parvicellular part
PH	posterior hypothalamic nucleus
PHA	posterior hypothalamic area
PHD	posterior hypothalamic area, dorsal part
Pi	pineal gland
PIF	parainterfascicular nucleus of the VTA
PIL	posterior intralaminar thalamic nucleus
Pir	piriform cortex
PL	paralemniscal nucleus
PLCo	posterolateral cortical amygdaloid area
plf	posterolateral fissure
PLH	peduncular part of lateral hypothalamus
PLi	posterior limitans thalamic nucleus
PlPAG	pleoglial periaqueductal gray
PLV	perilemniscal nucleus, ventral part
PM	paramedian lobule
pm	principal mammillary tract
PMCo	posteromedial cortical amygdaloid area
PMD	premammillary nucleus, dorsal part
PMn	paramedian reticular nucleus
PMnR	paramedian raphe nucleus
PMV	premammillary nucleus, ventral part
PN	paranigral nucleus of the VTA
Pn	pontine nuclei
PnC	pontine reticular nucleus, caudal part
PnO	pontine reticular nucleus, oral part
PnR	pontine raphe nucleus
PnV	pontine reticular nucleus, ventral part
Po	posterior thalamic nuclear group
PoDG	polymorph layer of the dentate gyrus
PoMn	posteromedian thalamic nucleus
PoRh	postrhinal cortex
Post	postsubiculum
PoT	posterior thalamic nuclear group, triangular part
PP	peripeduncular nucleus
ppf	prepyramidal fissure
PPT	posterior pretectal nucleus
PPy	parapyramidal nucleus
Pr	prepositus nucleus
PR	prerubral field
Pr5	principal sensory trigeminal nucleus
Pr5DM	principal sensory trigeminal nucleus, dorsomedial part
Pr5VL	principal sensory trigeminal nucleus, ventrolateral part
PrBo	pre-Botzinger complex
PrC	precommissural nucleus
PrCnF	precuneiform area
PrEW	pre-Edinger-Westphal nucleus
prf	primary fissure
PRh	perirhinal cortex
PrL	prelimbic cortex
PrS	presubiculum
PS	parastrial nucleus
psf	posterior superior fissure
PSol	parasolitary nucleus
PSTh	parasubthalamic nucleus
PT	paratenial thalamic nucleus
PTg	pedunculotegmental nucleus
PtPD	parietal cortex, posterior area, dorsal part
PtPR	parietal cortex, posterior area, rostral part
PV	paraventricular thalamic nucleus
PVA	paraventricular thalamic nucleus, anterior part
PVG	periventricular gray
PVP	paraventricular thalamic nucleus, posterior part
Py	pyramidal cell layer of the hippocampus
py	pyramidal tract
pyx	pyramidal decussation
R	red nucleus
r1Rt	r1 reticular formation
Rad	radiatum layer of the hippocampus
RAmb	retroambiguus nucleus
RAPir	rostral amygdalopiriform area
Rbd	rhabdoid nucleus
RCh	retrochiasmatic area
RChL	retrochiasmatic area, lateral part
Re	reuniens thalamic nucleus
ReIC	recess of the inferior colliculus
REth	retroethmoid nucleus
rf	rhinal fissure
Rh	rhomboid thalamic nucleus
RI	rostral interstitial nucleus
RIP	raphe interpositus nucleus
RLi	rostral linear nucleus (midbrain)
RM	retromammillary nucleus
RMC	red nucleus, magnocellular part
RMg	raphe magnus nucleus
RML	retromammillary nucleus, lateral part
RMM	retromammillary nucleus, medial part
rmx	retromammillary decussation
Ro	nucleus of Roller
ROb	raphe obscurus nucleus
RPa	raphe pallidus nucleus
RPC	red nucleus, parvicellular part
RPF	retroparafascicular nucleus
RR	retrorubral nucleus
RRe	retrouniens area
RRF	retrorubral field
RRF/A8	retrorubral field and A8 dopamine cells
rs	rubrospinal tract
RSD	retrosplenial dysgranular cortex
RSG	retrosplenial granular cortex
RSGa	retrosplenial granular cortex, a region
RSGb	retrosplenial granular cortex, b region
RSGc	retrosplenial granular cortex, c region
Rt	reticular nucleus (prethalamus)
RtTg	reticulotegmental nucleus of the pons
RtTgP	reticulotegmental nucleus of the pons, pericentral part
RVL	rostroventrolateral reticular nucleus
RVRG	rostral ventral respiratory group
S	subiculum
S1	primary somatosensory cortex
S1BF	primary somatosensory cortex, barrel field
S1DZ	primary somatosensory cortex, dysgranular zone
S1FL	primary somatosensory cortex, forelimb region
S1HL	primary somatosensory cortex, hindlimb region
S1J	primary somatosensory cortex, jaw region
S1Sh	primary somatosensory cortex, shoulder region
S1Tr	primary somatosensory cortex, trunk region
S1ULp	primary somatosensory cortex, upper lip region
S2	secondary somatosensory cortex
s5	sensory root of the trigeminal nerve
Sag	sagulum nucleus
Sc	scaphoid thalamic nucleus
SC	superior colliculus
scc	splenium of the corpus callosum
SCh	suprachiasmatic nucleus
SChDL	suprachiasmatic nucleus, dorsolateral part
SChVM	suprachiasmatic nucleus, ventromedial part
SCO	subcommissural organ
scp	superior cerebellar peduncle
scpd	superior cerebellar peduncle, descending limb
sf	secondary fissure
SFi	septofimbrial nucleus
SFO	subfornical organ
SG	suprageniculate thalamic nucleus
SGe	supragenual nucleus
SHi	septohippocampal nucleus
SHy	septohypothalamic nucleus
SI	substantia innominata
SIB	substantia innominata, basal part
Sim	simple lobule
SLu	stratum lucidum of the hippocampus
SM	nucleus of the stria medullaris
sm	stria medullaris
SMT	submammillothalamic nucleus
SMV	superior medullary velum
SN	substantia nigra
SNC	substantia nigra, compact part
SNCD	substantia nigra, compact part, dorsal tier
SNCM	substantia nigra, compact part, medial tier
SNL	substantia nigra, lateral part
SNR	substantia nigra, reticular part
SO	supraoptic nucleus
Sol	solitary nucleus
sol	solitary tract
SolC	solitary nucleus, commissural part
SolCe	solitary nucleus, central part
SolDL	solitary nucleus, dorsolateral part
SolDM	solitary nucleus, dorsomedial part
SolG	solitary nucleus, gelatinous part
SolI	solitary nucleus, interstitial part
SolIM	solitary nucleus, intermediate part
SolL	solitary nucleus, lateral part
SolM	solitary nucleus, medial part
SolV	solitary nucleus, ventral part
SolVL	solitary nucleus, ventrolateral part
SOR	supraoptic nucleus, retrochiasmatic part
sox	supraoptic decussation
sp5	spinal trigeminal tract
Sp5C	spinal trigeminal nucleus, caudal part
Sp5I	spinal trigeminal nucleus, interpolar part
Sp5O	spinal trigeminal nucleus, oral part
SPa	subparaventricular zone of the hypothalamus
SPF	subparafascicular thalamic nucleus
SPFPC	subparafascicular thalamic nucleus, parvicellular part
Sph	sphenoid nucleus
SPO	superior paraolivary nucleus
SPTg	subpeduncular tegmental nucleus
SpVe	spinal vestibular nucleus
ST	bed nucleus of the stria terminalis
st	stria terminalis
StA	strial part of the preoptic area
Stg	stigmoid hypothalamic nucleus
STh	subthalamic nucleus
StHy	striohypothalamic nucleus
STIA	bed nucleus of the stria terminalis, intraamygdaloid
STLD	bed nucleus of the stria terminalis, lateral division
STLI	bed nucleus of the stria terminalis, lateral division
STLJ	bed nucleus of the stria terminalis, lateral division ,juxtacapsular part
STLP	bed nucleus of the stria terminalis, lateral division, posterior part
STLV	bed nucleus of the stria terminalis, lateral division, ventral part
STMA	bed nucleus of the stria terminalis, medial division, anterior part
STMAL	bed nucleus of the stria terminalis, medial division, anterolateral part
STMAM	bed nucleus of the stria terminalis, medial division, anteromedial part
STMP	bed nucleus of the stria terminalis, medial division, posterior part
STMPI	bed nucleus of the stria terminalis, medial division, posterior intermediate part
STMPL	bed nucleus of the stria terminalis, medial division, posterolateral part
STMPM	bed nucleus of the stria terminalis, medial division, posteromedial part
STMV	bed nucleus of the stria terminalis, medial division, ventral part
STr	subiculum, transition area
str	superior thalamic radiation
STS	bed nucleus of stria terminalis, supracapsular division
Su3	supraoculomotor periaqueductal gray
Su3C	supraoculomotor cap
Su5	supratrigeminal nucleus
Sub	submedius thalamic nucleus
SubB	subbrachial nucleus
SubCA	subcoeruleus nucleus, alpha part
SubCD	subcoeruleus nucleus, dorsal part
SubCV	subcoeruleus nucleus, ventral part
SubG	subgeniculate nucleus of prethalamus (ventrolateral n)
SubI	subincertal nucleus
SubP	subpostrema area
SuG	superficial gray layer of the superior colliculus
SuS	superior salivatory nucleus
SuVe	superior vestibular nucleus
Te	terete hypothalamic nucleus
TeA	temporal association cortex
tfp	transverse fibers of the pons
TG	tectal gray formation (midbrain)
TrLL	triangular nucleus, lateral lemniscus
ts	tectospinal tract
TS	triangular septal nucleus
Tu	olfactory tubercle
TuLH	tuberal region of lateral hypothalamus
Tz	nucleus of the trapezoid body
tz	trapezoid body
un	uncinate fasciculus of the cerebellum
V1	primary visual cortex
V1B	primary visual cortex, binocular area
V1M	primary visual cortex, monocular area
V2L	secondary visual cortex, lateral area
V2ML	secondary visual cortex, mediolateral area
V2MM	secondary visual cortex, mediomedial area
VA	ventral anterior thalamic nucleus
VCA	ventral cochlear nucleus, anterior part
VCAGr	ventral cochlear nucleus, granule cell layer
VCCap	ventral cochlear nucleus, capsular part
VCl	ventral part of claustrum
VCP	ventral cochlear nucleus, posterior part
VCPO	ventral cochlear nucleus, posterior part, octopus cell area
VDB	nucleus of the vertical limb of the diagonal band
VeCb	vestibulocerebellar nucleus
veme	vestibulomesencephalic tract
VEn	ventral endopiriform claustrum
vert	vertebral artery
vesp	vestibulospinal tract
VG	ventral geniculate nucleus
vhc	ventral hippocampal commissure
VIEnt	ventral intermediate entorhinal cortex
VL	ventrolateral thalamic nucleus
VLH	ventrolateral hypothalamic nucleus
VLi	ventral linear nucleus of the thalamus
VLL	ventral nucleus of the lateral lemniscus
VLPAG	ventrolateral periaqueductal gray
VLPO	ventrolateral preoptic nucleus
VM	ventromedial thalamic nucleus
VMH	ventromedial hypothalamic nucleus
VMHC	ventromedial hypothalamic nucleus, central part
VMHDM	ventromedial hypothalamic nucleus, dorsomedial part
VMHSh	ventromedial hypothalamic nucleus, shell region
VMHVL	ventromedial hypothalamic nucleus, ventrolateral part
VMPO	ventromedial preoptic nucleus
vn	vomeronasal nerve
VO	ventral orbital cortex
VOLT	vascular organ of the lamina terminalis
VP	ventral pallidum
VPL	ventral posterolateral thalamic nucleus
VPM	ventral posteromedial thalamic nucleus
VPPC	ventral posterior nucleus of the thalamus, parvicellular part
VRe	ventral reuniens thalamic nucleus
VS	ventral subiculum
vsc	ventral spinocerebellar tract
VTA	ventral tegmental area
VTAR	ventral tegmental area, rostral part
VTg	ventral tegmental nucleus
vtgx	ventral tegmental decussation
VTM	ventral tuberomammillary nucleus
VTT	ventral tenia tecta
X	nucleus X
Xi	xiphoid thalamic nucleus
xscp	decussation of the superior cerebellar peduncle
Y	nucleus Y
ZI	zona incerta
ZIC	zona incerta, caudal part
ZID	zona incerta, dorsal part
ZIR	zona incerta, rostral part
ZIV	zona incerta, ventral part
ZL	zona limitans
Zo	zona layer of the superior colliculus